1111111111111111111111111111111111111111
1111C011111000C00111111100T000111E000001
1111001111110000111111000000001101111001
1100001111111110011111110011111000000011
11T00111111000000000000000111110111100C1
1000000111111111000000000011100011100011
1000000001111100000000001111100111110001
1100001111111111111100000000000011111111
1C1001100000000000000000000000001C001111
1011011111000T00000000000000000010101111
1000011000000000000000000000000000100C11
1100111111110000001111111110001111111111
1110001111111110000011000111101111111111
11111000011100001110000111111000000000C1
1100000011000001100001111111111111111111
11111100000111000011000111111000T000C001
111C00001100000110000T0001110111111111P1
1111111111111000000111111000C11111111101
1111110000011110111111111011110000001C01
1111110110000000111110000011111111111001
111C000111111000000000111000000000000001
1111111111111111111111111111111111111111