11111111111111111111
1C10C1111111000CP111
1T10TC11110000000111
10010TT1100011100111
10111000001110T00011
1000110C00111CT00011
11001111000011111111
1C0001111001C1C01111
1110000000000110T111
11000T001111111T0111
110001100T01110000E1
11111110010000000111
11C11000111111000111
11T00001111111000C11
11111111111111111111