111111111111111111111111111111111111111
1000100010001000100010001000100010001E1
101010101010101010101010101010101010101
101010101010101010101010101010101010101
101010101010101010101010101010101010101
101010101010101010101010101010101010101
101010101010101010101010101010101010101
101010101010101010101010101010101010101
101010101010101010101010101010101010101
101010101010101010101010101010101010101
101010101010101010101010101010101010101
101010101010101010101010101010101010101
101010101010101010101010101010101010101
101010101010101010101010101010101010101
101010101010101010101010101010101010101
101010101010101010101010101010101010101
101010101010101010101010101010101010101
101010101010101010101010101010101010101
101010101010101010101010101010101010101
101010101010101010101010101010101010101
101010101010101010101010101010101010101
1P1000100010001000100010001000100010001
111111111111111111111111111111111111111