1111111111111
1P00000000001
1011111111101
10C00000000E1
1111111111111