11111111
100111C1
1CT10001
1100T111
1E0000P1
11111111